################
#..............#
#.##############
#..............#
#############..#
#..............#
#.##############
#..............#
#############..#
#..............#
#..............#
################
